"a" = (/turf,/area)
"b" = (/turf/pavement,/area)
"c" = (/turf/street_asphalt/street_asphalt_left,/area)
"d" = (/turf/street_asphalt/street_asphalt_normal,/area)
"e" = (/turf/street_asphalt/street_asphalt_right,/area)
"f" = (/turf/street_asphalt/street_asphalt_middle,/area)
"g" = (/obj/items/food/poisons/toxin,/turf,/area)
"h" = (/turf/walls/wall_brick_corner_lefttop,/area/house/livingroom)
"i" = (/turf/walls/wall_brick_bottom,/area/house/livingroom)
"j" = (/turf/walls/wall_brick_corner_righttop,/area/house/livingroom)
"k" = (/turf/walls/wall_brick_right,/area/house/livingroom)
"l" = (/obj/items/food/poisons/toxin,/turf/tile_white,/area/house/livingroom)
"m" = (/obj/items/food/poisons/toxin,/turf/wood_light_planks,/area/house/livingroom)
"n" = (/turf/walls/wall_brick_corner_leftbottom,/area/house/livingroom)
"o" = (/turf/walls/wall_brick_corner_rightbottom,/area/house/livingroom)
"p" = (/turf/spawns/human,/area)

(1,1,1) = {"
aaaaaaaaaaaaabcdddebaaaaaaaaaaaaaaaaaaaaaaaaaaaaaa
aaaaaaaaaaaaabcdfdebaaaaaaaaaaaaaaaaaaaaaaaaaaaaaa
aaaaaaaaaaaaabcdddebaaaaaaaaaaaaaaaaaaaaaaaaaaaaaa
aaaaaaaaaaaaabcdfdebaaaaaaaaaaaaaaaaaaaaaaaaaaaaaa
aaaaaaaaaaaaabcdddebaaaaaaaaaaaaaaaaaaaaaaaaaaaaaa
aaaaaaaaaaaaabcdfdebaaaaaaaaaaaaaaaaaaaaaaaaaaaaaa
aaaaaaaaaaaaabcdddebaaaaaaaaaaaaaaaaaaaaaaaaaaaaaa
aaaaaaaaaaaaabcdfdebaaaaaaaaaaaaaaaaaaaaaaaaaaaaaa
aaaaaaaaaaaaabcdddebaaaaaaaaaaaaaaaaaaaaaaaaaaaaaa
aaaaaaaaaaaaabcdfdebaaaaaaaaaaaaaaaaaaaaaaaaaaaaaa
aaaaaaaaaaaaabcdddebaaaaaaaaaaaaaaaaaaaaaaaaaaaaaa
aaaaaaaaaaaaabcdfdebaaaaaaaaaaaaaaaaaaaaaaaaaaaaaa
aaaaaaaaaaaaabcdddebaaaaaaaaaaaaaaaaaaaaaaaaaaaaaa
aaaaaaaaaaaaabcdfdebaaaaaaaaaaaaaaaaaaaaaaaaaaaaaa
aaaaaaaaaaaaabcdddebaaaaaaaaaaaaaaaaaaaaaaaaaaaaaa
aaaaaaaaaaaaabcdfdebaaaaaaaaaaaaaaaaaaaaaaaaaaaaaa
aaaaaaagggggabcdddebaaaaaaaaaaaaaaaaaaaaaaaaaaaaaa
aaaaaaagggggabcdfdebaaaaaaaaaaaaaaaaaaaaaaaaaaaaaa
aaaaaaagggggabcdddebaaaaaaaaaaaaaaaaaaaaaaaaaaaaaa
aaaaaaahiiijabcdfdebaaaaaaaaaaaaaaaaaaaaaaaaaaaaaa
aaaaaaakllmkabcdddebaaaaaaaaaaaaaaaaaaaaaaaaaaaaaa
aaaaaaakmmmkabcdfdebaaaaaaaaaaaaaaaaaaaaaaaaaaaaaa
aaaaaaakmmmkabcdddebaaaaaaaaaaaaaaaaaaaaaaaaaaaaaa
aaaaaaanimioabcdfdebaaaaaaaaaaaaaaaaaaaaaaaaaaaaaa
aaaaaaaaaaaaabcdddebaaaaaaaaaaaaaaaaaaaaaaaaaaaaaa
aaaaaaaaapaaabcdfdebaaaaaaaaaaaaaaaaaaaaaaaaaaaaaa
aaaaaaaaaaaaabcdddebaaaaaaaaaaaaaaaaaaaaaaaaaaaaaa
aaaaaaaaaaaaabcdfdebaaaaaaaaaaaaaaaaaaaaaaaaaaaaaa
aaaaaaaaaaaaabcdddebaaaaaaaaaaaaaaaaaaaaaaaaaaaaaa
aaaaaaaaaaaaabcdfdebaaaaaaaaaaaaaaaaaaaaaaaaaaaaaa
aaaaaaaaaaaaabcdddebaaaaaaaaaaaaaaaaaaaaaaaaaaaaaa
aaaaaaaaaaaaabcdfdebaaaaaaaaaaaaaaaaaaaaaaaaaaaaaa
aaaaaaaaaaaaabcdddebaaaaaaaaaaaaaaaaaaaaaaaaaaaaaa
aaaaaaaaaaaaabcdfdebaaaaaaaaaaaaaaaaaaaaaaaaaaaaaa
aaaaaaaaaaaaabcdddebaaaaaaaaaaaaaaaaaaaaaaaaaaaaaa
aaaaaaaaaaaaabcdfdebaaaaaaaaaaaaaaaaaaaaaaaaaaaaaa
aaaaaaaaaaaaabcdddebaaaaaaaaaaaaaaaaaaaaaaaaaaaaaa
aaaaaaaaaaaaabcdfdebaaaaaaaaaaaaaaaaaaaaaaaaaaaaaa
aaaaaaaaaaaaabcdddebaaaaaaaaaaaaaaaaaaaaaaaaaaaaaa
aaaaaaaaaaaaabcdfdebaaaaaaaaaaaaaaaaaaaaaaaaaaaaaa
aaaaaaaaaaaaabcdddebaaaaaaaaaaaaaaaaaaaaaaaaaaaaaa
aaaaaaaaaaaaabcdfdebaaaaaaaaaaaaaaaaaaaaaaaaaaaaaa
aaaaaaaaaaaaabcdddebaaaaaaaaaaaaaaaaaaaaaaaaaaaaaa
aaaaaaaaaaaaabcdfdebaaaaaaaaaaaaaaaaaaaaaaaaaaaaaa
aaaaaaaaaaaaabcdddebaaaaaaaaaaaaaaaaaaaaaaaaaaaaaa
aaaaaaaaaaaaabcdfdebaaaaaaaaaaaaaaaaaaaaaaaaaaaaaa
aaaaaaaaaaaaabcdddebaaaaaaaaaaaaaaaaaaaaaaaaaaaaaa
aaaaaaaaaaaaabcdfdebaaaaaaaaaaaaaaaaaaaaaaaaaaaaaa
aaaaaaaaaaaaabcdddebaaaaaaaaaaaaaaaaaaaaaaaaaaaaaa
aaaaaaaaaaaaabcdfdebaaaaaaaaaaaaaaaaaaaaaaaaaaaaaa
"}

(1,1,2) = {"
aaaaaaaaaaaaaaaaaaaaaaaaaaaaaaaaaaaaaaaaaaaaaaaaaa
aaaaaaaaaaaaaaaaaaaaaaaaaaaaaaaaaaaaaaaaaaaaaaaaaa
aaaaaaaaaaaaaaaaaaaaaaaaaaaaaaaaaaaaaaaaaaaaaaaaaa
aaaaaaaaaaaaaaaaaaaaaaaaaaaaaaaaaaaaaaaaaaaaaaaaaa
aaaaaaaaaaaaaaaaaaaaaaaaaaaaaaaaaaaaaaaaaaaaaaaaaa
aaaaaaaaaaaaaaaaaaaaaaaaaaaaaaaaaaaaaaaaaaaaaaaaaa
aaaaaaaaaaaaaaaaaaaaaaaaaaaaaaaaaaaaaaaaaaaaaaaaaa
aaaaaaaaaaaaaaaaaaaaaaaaaaaaaaaaaaaaaaaaaaaaaaaaaa
aaaaaaaaaaaaaaaaaaaaaaaaaaaaaaaaaaaaaaaaaaaaaaaaaa
aaaaaaaaaaaaaaaaaaaaaaaaaaaaaaaaaaaaaaaaaaaaaaaaaa
aaaaaaaaaaaaaaaaaaaaaaaaaaaaaaaaaaaaaaaaaaaaaaaaaa
aaaaaaaaaaaaaaaaaaaaaaaaaaaaaaaaaaaaaaaaaaaaaaaaaa
aaaaaaaaaaaaaaaaaaaaaaaaaaaaaaaaaaaaaaaaaaaaaaaaaa
aaaaaaaaaaaaaaaaaaaaaaaaaaaaaaaaaaaaaaaaaaaaaaaaaa
aaaaaaaaaaaaaaaaaaaaaaaaaaaaaaaaaaaaaaaaaaaaaaaaaa
aaaaaaaaaaaaaaaaaaaaaaaaaaaaaaaaaaaaaaaaaaaaaaaaaa
aaaaaaaaaaaaaaaaaaaaaaaaaaaaaaaaaaaaaaaaaaaaaaaaaa
aaaaaaaaaaaaaaaaaaaaaaaaaaaaaaaaaaaaaaaaaaaaaaaaaa
aaaaaaaaaaaaaaaaaaaaaaaaaaaaaaaaaaaaaaaaaaaaaaaaaa
aaaaaaaaaaaaaaaaaaaaaaaaaaaaaaaaaaaaaaaaaaaaaaaaaa
aaaaaaaaaaaaaaaaaaaaaaaaaaaaaaaaaaaaaaaaaaaaaaaaaa
aaaaaaaaaaaaaaaaaaaaaaaaaaaaaaaaaaaaaaaaaaaaaaaaaa
aaaaaaaaaaaaaaaaaaaaaaaaaaaaaaaaaaaaaaaaaaaaaaaaaa
aaaaaaaaaaaaaaaaaaaaaaaaaaaaaaaaaaaaaaaaaaaaaaaaaa
aaaaaaaaaaaaaaaaaaaaaaaaaaaaaaaaaaaaaaaaaaaaaaaaaa
aaaaaaaaaaaaaaaaaaaaaaaaaaaaaaaaaaaaaaaaaaaaaaaaaa
aaaaaaaaaaaaaaaaaaaaaaaaaaaaaaaaaaaaaaaaaaaaaaaaaa
aaaaaaaaaaaaaaaaaaaaaaaaaaaaaaaaaaaaaaaaaaaaaaaaaa
aaaaaaaaaaaaaaaaaaaaaaaaaaaaaaaaaaaaaaaaaaaaaaaaaa
aaaaaaaaaaaaaaaaaaaaaaaaaaaaaaaaaaaaaaaaaaaaaaaaaa
aaaaaaaaaaaaaaaaaaaaaaaaaaaaaaaaaaaaaaaaaaaaaaaaaa
aaaaaaaaaaaaaaaaaaaaaaaaaaaaaaaaaaaaaaaaaaaaaaaaaa
aaaaaaaaaaaaaaaaaaaaaaaaaaaaaaaaaaaaaaaaaaaaaaaaaa
aaaaaaaaaaaaaaaaaaaaaaaaaaaaaaaaaaaaaaaaaaaaaaaaaa
aaaaaaaaaaaaaaaaaaaaaaaaaaaaaaaaaaaaaaaaaaaaaaaaaa
aaaaaaaaaaaaaaaaaaaaaaaaaaaaaaaaaaaaaaaaaaaaaaaaaa
aaaaaaaaaaaaaaaaaaaaaaaaaaaaaaaaaaaaaaaaaaaaaaaaaa
aaaaaaaaaaaaaaaaaaaaaaaaaaaaaaaaaaaaaaaaaaaaaaaaaa
aaaaaaaaaaaaaaaaaaaaaaaaaaaaaaaaaaaaaaaaaaaaaaaaaa
aaaaaaaaaaaaaaaaaaaaaaaaaaaaaaaaaaaaaaaaaaaaaaaaaa
aaaaaaaaaaaaaaaaaaaaaaaaaaaaaaaaaaaaaaaaaaaaaaaaaa
aaaaaaaaaaaaaaaaaaaaaaaaaaaaaaaaaaaaaaaaaaaaaaaaaa
aaaaaaaaaaaaaaaaaaaaaaaaaaaaaaaaaaaaaaaaaaaaaaaaaa
aaaaaaaaaaaaaaaaaaaaaaaaaaaaaaaaaaaaaaaaaaaaaaaaaa
aaaaaaaaaaaaaaaaaaaaaaaaaaaaaaaaaaaaaaaaaaaaaaaaaa
aaaaaaaaaaaaaaaaaaaaaaaaaaaaaaaaaaaaaaaaaaaaaaaaaa
aaaaaaaaaaaaaaaaaaaaaaaaaaaaaaaaaaaaaaaaaaaaaaaaaa
aaaaaaaaaaaaaaaaaaaaaaaaaaaaaaaaaaaaaaaaaaaaaaaaaa
aaaaaaaaaaaaaaaaaaaaaaaaaaaaaaaaaaaaaaaaaaaaaaaaaa
aaaaaaaaaaaaaaaaaaaaaaaaaaaaaaaaaaaaaaaaaaaaaaaaaa
"}
